111111111
10E000P01
100000C01
111111111
