11111111111111111111111111
1P000000000001000C00000001
10001111110001000111111001
10000000C10000000000001001
10111110011111100111101001
10000000000000000000001001
10001111111111111110001001
10001000000000000100001001
10001001111111000100001001
10001001000001000100001001
10001001000001000100001001
10001001111111000100001001
10001000000000000100001001
10001111111111111110001001
10000000000000000000001001
10111110011111100111101001
10000000010000000000001001
10001111110001000111111001
100C00000000100000000000E1
11111111111111111111111111