11111111111111111111111111111111111111111111111111111111111111111111111111111111111111111111111111
1P000000000000000000000000000000000000000000000000000000000000000000000000000000000000000000000001
10001111111111111111111111111111000000000000000C000000000000000000000000000000000E0000000000000001
10000000000000000000000000000001111111111111111111110000000000000000000000000000000000000000000001
10111111111111111100001111111111100000000000000000001111111111111111111100000000000000000000000001
1000000000000000000000C000000000111111111100000000000000000000000000000000000000000000000000000001
10000001111111111111111111111100000000000000000000000001111111111110000000000000000000000000000001
10001000000000000000000000000111111100000000001111111100000000000000111111111111111111111111111101
100010011111110000111111100001000000000000000010000000000C0000000000000000000000000000000000000001
10001001000001000000000010000100001111111111101000011111111111111111000000000000000000000000000001
1000100100000100C000000010000000001000C00000001000010000000000000001111111111111111111111111111101
10001001111111000011111110000100001001111111111000010001111111111111000000000000000000000000000001
10001000000000000000000000000100001000000000000000010000000000000001111111111111111111111111111111
11111111111111111111111111111111111111111111111111111111111111111111111111111111111111111111111111