11111
1P001
10001
101C1
10001
10101
10001
10101
10001
10101
10001
10101
10001
10101
10001
10101
10001
10101
10001
10101
10001
10101
10001
1C101
10001
10101
10001
10101
10001
10101
10001
10101
10001
101C1
10001
10101
10001
10101
10001
10101
10001
10101
10001
10101
10001
10101
10001
10101
10001
10101
10001
10101
10001
10101
10001
10101
10001
10101
10001
10101
10001
10101
10001
10101
10001
10101
10001
10101
10001
10101
10001
10101
10001
10101
10001
10101
10001
10101
10001
10101
10001
10101
10001
10101
10001
10101
10001
10101
10001
10101
10001
10101
10001
10101
10001
10101
1E001
11111