111111111
10P000C01
10E01C001
100000C01
111111111