1111111111111
100000CE00001
111P000000C10
1000000000000
1111111111110