11111111111111111
1000P000000E00001
111100C000000111111111
111111111111111111