1111111111111
100200CE00001
111P001000C11
1000201020001
1111111111111