11111111111111111
1000P100000E00001
11110001100001111
11111111111111111