111111111111111
10E010P00100001
10C01C000P01101
111111111111111
