111111111111111
100010P0010E001
10C01C000101101
111111111111111