111111111111111
10E010P0010E001
10C01C000001101
111111111111111